6 7
22 5

1

-1

# # # # # #
# # # # # #
# # . . . #
. . . G . #
# # . . . #
# # # # # #
# # # # # #