18 11
18 5

19

1

# # # . . . . . . . . . . . . # # #
# # . . . . . . . . . . . . . . # # 
# . . . . . . . . . . . . . . . . # 
. . . # . . . . . . . . . . # . . . 
. . . . . . . . . . . . . . . . . . 
. . . . . . . . @ . . . . . . . . Y 
. . . . . . . . . . . . . . . . . . 
. . . # . . . . . . . . . . # . . . 
# . . . . . . . . . . . . . . . . #
# # . . . . . . . . . . . . . . # #
# # # . . . . . . . . . . . . # # #
